********************
*...........*......*
*...........*...k..*
*...........*......*
*...........*......*
*...........*......*
*...........***d****
*..................*
*..................*
*....p.............*
*..................*
*..................*
*..................*
*........***d*******
*........*.........*
*........*.........*
*........*.........*
*........*.........*
*........*.........*
***************D****