********************
*..................*
*..................*
*..................*
*..................*
*..................*
*..................*
*.......**.**......*
*......*..*..*.....*
*.....*...p...*....*
*.....*.......*....*
*......D..k..*.....*
*.......*...*......*
*........*.*.......*
*.........*........*
*..................*
*.........k........*
*..................*
*..................*
***************D****